-1 -1 -1 -1 -1 -1 -1 -1 -1 -1 -1 -1 -1
-1 1 2 3 4 5 6 7 8 9 10 11 22 23 14 -1
-1 12 13 14 15 -1 -1 -1 -1 25 26 -1 -1
-1 16 17 18 19 20 21 -1 -1 27 28 -1 -1
-1 19 30 31 32 -1 -1 -1 33 34 35 36 -1
-1 -1 -1 37 38 39 40 -1 -1 -1 41 42 -1
-1 -1 43 44 45 46 47 48 49 50 -1 -1 -1
